MGGGGMGAGGGGGGGGMMMMMMMGGGMMMMMGGGGMMMGGGG
MGMMMMGAGMMMMGGMMMMMMMMMGGMGGGMGGMMMMMMMGG
MGGGGMGAGMGGMGMMMMMMMMMMMGMMGMMGMMMMVMMMMG
MGMMMMGAGMGGMGMMMMMMMMMMMGGMGMGMMMMVVVMMMM
MGGGGMGAGGGGGGGMMMMMMMMMGGGMGMGMMMVVVVVMMM
MMMMGMGAAAAAGGGGGMMMMMGGGMGMGMGMMMMVVVMMMM
GMGGGGGGGGGAGMMGGGGGGGGGGMGMGMGGMMMMVMMMMG
GMGGGGMMMMGAGMMGGGGMGGMGGGGGGGGGGMMMMMMMGG
GGGGMGGGGGGGGGGGGGMMMGGGMMMMMMMGGGGMMMGGGG
GGMGGGGGMMGAGMMGMGGMGGGGGGGGGGGGGGGGGGGGMG
GGMGMMMGMMGAGMMGMGGGGGGGMMMGGGMMMGMMMMGGMG
GGMGGGGGGGGAGGGGMMMMMGGMMMMMGGMMMGGGGGGGGG
GGMGGGGGGGGAAAAGMGGMGGMMMMMMMGGGGGMGGMMMMG
GGGGGGGGMGGGGGAGMGGMGGMMMAMMMGGGGGMGGGGGGG
MMMMGMGMMMGGGGAGGGGMGGGMMAMMGGGGMMMMMMMGGG
GGGGGMGMMMGGAAAAAGGMGGGGGAGGGGGGGGGMGGGGGG
GGMGGMGGMGGAAAAAAAGGGMMMGAGGGMGGMGGMGGGGGG
MGMGGMGGGGAAAAAAAAAGGGGGGAGMMMMGMGGMGGGGMM
MGMGGMGGGGAAAGGGAAAGGMGGGAGGGMGGMGGGGMMMMM
MGMGMMMGGGAAAGGGAAAGMMMGGAGGGGGGMMMGMMMMMM
MGGGGGGGGGAAAGGGAAAGMMMGGAAAAAAGGGGGGGGGMM
MMMMMGGGGGAAAAAAAAAGMMMGGGGGGGAGMMMGMMMMMM
GGGGMGMGGGGAAAAAAAGGGMGGGMMMGGAGMGGGGMMMMM
GGGGMGMGGGGGAAAAAGGGGGGGGMMMGGAGMGMMGGGGMM
GGMGGGMGMMGGGGAGGGGGGMMMGGGGGGAGMGMGGGGGGG
GMMMGGMGMMMMGGAGGGMMGGGGGGMGGGAGGGMMMMGGGG
GMMMGMMGGGGGGGAGGMMMMGGGMGMGGAAAGGGMMMGGMG
GMMMGGGGMMMGGGAGMMMMMMGGMGGGAAAAAGGGGGGGMG
GGMGGGGGGGGGGGAGMMMMMMGGMGGAAAAAAAGGMMMMMG
MGGGMGGMAAAAAAAGGMMMMGGGMGGGAAAAAGGGMGGGMG
MMGMMMGGAGGGGGMGGGMMGGMMMMGGGAAAGGGGGGGGGG
MMGMMMGGAGGGGGMGMGGGGGGGGGGGGGGGGMMMMGMMMG
MGGGMGGGAGMMMMMGMMMMGMMMMMMGGGGMGGGMGGGMGG
GGGGGGGGGGGGGGGGGGGGGGGGGGMGGMMMMMGMGMGMGM
GMGGGGGMAGMMMGMMMMMMMMMMGMMGGGGGGGGGGGGMGM
GMGGGGMGAGGMGGMGGGGGGGGMGMGGMMMMCMMMMGGMGM
GMMMGGMGAGGMGGMGMMMMMMGMGGGMMMVVCVVMMMGGGM
GMGGGGMGAGGGGGMGMGGGGMGMGGMMVVVVCVVVVMMGGM
MMGMMMMGAAAAGGMGGGGGGMGMGGMMVVVVCVVVVMMGGG
MGGGGGMGGGGAGGMMMMMMMMGMGMMVVVVVCVVVVVMMGG
MGMMMGMGGGGAGGGGGGGGGGGGGMMVVVVVCVVVVVMMGG
MGGGGGMGGGGAGGMMMMMMMMMMGMMVVVVVVVVVVVMMGG
